18 18 18 18 18 18 18 18 18 18 18 18 18 18 18 18 18 18 18 18 18 18 18 18 18 18 18 18 18 18 18 18 18 18 18 18 18 18 18 18 18 18 18 18 18 18 18 19 19 18 
18 18 18 18 18 18 18 18 18 18 18 18 18 18 18 18 18 18 28 26 26 26 26 26 26 26 26 26 26 26 26 26 26 26 26 26 26 26 26 26 26 26 29 18 18 18 18 19 19 18 
18 18 18 18 18 18 18 18 18 18 18 18 18 18 18 18 18 28 27 1 1 1 1 1 1 1 1 1 1 1 1 1 1 1 1 1 1 1 1 1 1 1 25 29 18 18 18 19 19 18 
18 18 18 18 18 18 18 18 18 18 18 18 18 18 18 18 28 27 1 1 1 1 1 1 1 1 1 16 1 1 1 1 1 1 1 1 1 1 1 1 1 1 1 25 29 18 18 18 19 18 
18 18 18 18 18 18 18 18 18 18 18 18 18 18 19 28 27 1 1 1 1 1 1 1 1 1 1 1 1 1 1 2 1 1 1 1 16 16 16 16 16 16 1 1 25 29 18 18 18 18 
18 18 18 18 18 18 18 18 18 18 18 18 18 18 28 27 1 1 1 1 1 16 1 1 1 1 1 1 1 1 1 1 1 1 1 16 16 16 16 1 1 16 16 16 16 25 29 18 18 18 
18 18 18 18 18 18 18 18 18 18 18 28 26 26 27 1 1 1 1 1 1 1 1 1 1 12 10 10 10 10 10 10 10 10 10 16 16 16 16 16 1 1 1 1 1 1 25 29 18 18 
18 18 18 18 18 18 18 18 18 18 28 27 1 1 1 1 1 1 1 1 1 1 1 1 12 11 3 32 32 32 32 32 32 32 32 32 3 3 7 1 1 1 1 1 1 1 1 25 29 18 
18 18 18 18 18 18 18 18 18 28 27 1 1 1 1 16 1 1 1 2 1 12 10 10 11 3 3 32 17 17 17 17 17 17 17 32 3 3 7 1 16 1 1 16 1 1 1 1 23 18 
18 18 18 18 18 18 18 19 28 27 1 16 16 1 1 1 1 1 1 16 1 8 3 3 3 3 3 32 17 35 17 17 17 17 17 32 3 3 7 1 16 1 1 1 1 1 1 1 23 18 
18 18 18 18 18 18 18 28 27 1 1 16 16 1 1 1 1 1 1 16 1 8 3 3 3 3 3 32 17 17 17 17 37 17 17 32 3 3 7 16 16 1 1 16 16 1 1 1 23 18 
18 18 18 18 18 19 28 27 1 1 1 16 1 1 1 1 1 1 1 16 1 8 3 3 3 3 3 32 17 17 17 17 17 17 17 32 3 3 7 16 1 1 16 2 1 1 1 1 23 18 
18 18 18 28 26 26 27 1 1 1 1 16 1 1 16 16 16 1 1 16 16 8 3 3 3 3 3 32 17 17 17 17 17 17 17 32 3 4 15 1 1 1 16 1 2 1 1 1 23 18 
18 18 18 24 1 1 1 1 1 1 1 1 2 1 16 16 16 1 2 2 16 8 3 3 3 3 3 32 32 32 32 17 17 32 32 32 4 15 1 1 1 1 16 16 1 1 1 1 23 18 
18 18 28 27 1 1 1 1 1 1 1 1 1 1 16 16 1 2 16 16 1 8 3 3 3 3 3 3 3 3 3 3 3 3 3 3 7 2 1 1 1 16 16 16 16 1 1 1 23 18 
18 19 24 1 1 1 16 1 1 1 2 1 1 2 16 16 16 16 1 1 1 14 6 3 3 4 5 5 5 5 5 5 5 5 6 3 7 2 1 16 16 16 1 1 16 16 16 20 31 18 
18 19 24 1 1 16 16 1 1 1 16 16 16 16 16 16 16 16 16 1 1 1 1 6 4 15 1 1 1 1 1 1 2 2 14 5 15 1 16 1 1 1 1 1 1 1 16 23 18 18 
18 19 24 1 1 16 1 2 1 1 1 1 1 1 16 16 1 1 1 1 1 1 1 14 15 1 1 1 1 1 1 1 1 1 1 1 1 1 1 1 1 1 1 1 1 1 1 23 18 18 
18 18 24 1 1 16 16 16 1 1 1 1 1 1 16 1 1 16 16 16 1 1 1 1 1 1 1 1 1 1 16 1 1 1 1 1 1 1 1 1 2 1 1 1 1 20 21 31 18 18 
18 19 24 1 1 1 1 16 16 1 16 1 1 16 16 1 2 16 1 1 1 20 21 21 21 21 21 22 1 1 1 1 1 1 1 16 1 1 1 1 1 1 1 20 21 31 19 18 18 18 
18 19 24 1 1 1 1 1 1 1 1 1 1 1 1 1 2 16 16 1 1 23 18 18 18 18 19 24 1 1 1 1 16 1 16 16 1 1 1 1 1 1 1 23 18 18 18 18 18 18 
18 19 24 1 1 1 1 1 1 1 1 1 1 1 2 16 1 1 16 1 1 23 18 28 26 26 26 27 1 1 1 2 1 16 16 1 1 1 1 1 1 20 21 31 18 18 18 18 18 18 
18 19 24 1 16 1 1 16 16 1 1 1 1 2 16 16 16 16 16 1 1 23 18 24 1 1 1 1 1 1 1 1 1 16 16 16 1 1 1 1 1 23 19 18 18 18 18 18 18 18 
18 18 24 1 1 1 1 1 16 1 16 16 1 1 1 2 2 2 2 2 1 23 18 24 1 1 1 1 1 1 1 1 1 2 1 16 16 16 1 1 1 23 18 18 18 18 18 18 18 18 
18 18 24 1 1 1 1 1 16 1 16 16 1 1 1 1 1 1 2 2 1 23 18 30 21 21 22 1 1 1 1 16 1 2 1 1 1 16 1 1 1 23 18 18 18 18 18 18 19 18 
18 18 24 1 1 16 1 1 16 1 16 16 1 1 1 1 1 1 2 2 1 23 18 28 26 26 27 2 2 2 2 16 1 1 1 1 1 1 1 1 1 25 29 18 18 18 18 18 18 18 
18 18 24 1 2 16 2 2 16 16 16 16 16 16 16 2 2 2 2 2 1 23 18 24 1 1 1 12 10 10 13 2 12 10 10 13 1 1 1 1 1 1 23 18 18 18 18 18 18 18 
18 18 24 1 1 16 1 1 1 1 2 2 2 16 16 2 2 2 2 2 1 23 18 24 1 1 1 8 4 6 7 2 8 4 5 15 1 16 1 1 1 1 23 18 18 18 18 18 18 18 
18 18 24 1 1 16 2 2 1 1 2 2 2 2 16 2 1 1 1 2 1 23 18 24 1 1 16 8 9 11 7 2 8 7 1 1 1 1 2 2 1 1 23 18 18 18 19 18 18 18 
18 18 24 1 2 16 16 16 1 1 1 1 1 16 16 16 16 1 1 1 1 23 18 24 1 2 2 8 4 5 15 16 8 7 2 2 1 1 1 1 1 1 25 26 29 18 18 18 18 18 
18 18 24 1 1 1 1 16 1 1 16 1 1 16 1 1 1 1 1 1 1 23 18 24 1 2 2 8 9 11 7 2 8 7 2 2 1 16 2 1 1 1 1 1 23 18 18 18 18 18 
18 19 24 16 1 1 1 1 1 2 1 1 1 16 16 1 1 1 1 1 1 25 26 27 1 2 2 14 5 5 15 2 14 15 2 2 1 16 2 1 1 1 1 1 23 18 18 18 18 18 
18 18 24 1 1 1 1 1 1 2 1 1 1 1 16 1 1 1 1 1 1 1 16 16 16 2 2 16 2 2 2 2 2 2 2 2 2 16 16 2 1 1 1 1 23 18 18 18 18 18 
18 18 24 1 1 1 1 1 1 16 16 1 1 1 16 16 1 1 1 1 1 1 1 16 16 16 2 2 2 2 2 16 16 16 16 1 2 2 16 16 2 2 1 1 23 18 18 19 18 18 
18 18 30 22 1 1 1 1 16 16 16 1 1 16 16 16 16 16 1 1 2 1 1 1 1 16 16 2 16 16 2 16 2 2 1 2 2 2 2 16 2 2 2 2 23 18 18 18 18 18 
18 18 18 30 22 1 1 16 16 1 1 2 1 16 1 1 1 16 1 2 1 1 1 1 1 1 2 16 16 16 16 16 2 2 1 1 1 16 16 16 2 2 2 2 23 19 18 18 18 18 
18 18 18 18 30 21 22 1 1 1 1 1 1 16 1 1 1 16 16 1 1 1 1 1 1 1 16 16 1 16 16 2 2 2 2 2 2 16 16 16 16 2 2 2 25 26 26 29 18 18 
18 18 18 18 18 19 30 21 22 1 1 1 1 1 1 1 2 16 16 1 1 1 1 1 1 1 16 16 1 2 2 2 2 2 2 2 16 16 2 16 16 2 2 2 1 1 1 23 18 18 
18 18 18 18 18 18 18 18 24 1 1 1 1 1 1 1 1 1 16 1 1 1 1 1 2 2 1 16 1 1 2 2 1 2 1 1 16 16 1 1 2 2 1 16 16 1 1 23 18 18 
18 18 18 18 18 18 18 18 30 21 22 1 1 1 1 1 1 1 1 1 1 2 1 1 1 16 16 16 1 2 2 1 1 2 16 16 16 16 2 2 2 2 1 1 16 16 16 23 19 18 
18 18 18 18 18 18 18 18 18 18 30 21 21 22 1 1 1 1 1 1 1 1 1 1 1 1 16 16 1 2 2 2 2 2 2 16 16 16 2 2 2 2 2 2 1 1 1 25 29 18 
18 18 18 18 18 18 18 18 18 18 18 18 18 30 21 21 21 22 1 1 1 1 1 1 1 1 1 2 1 16 16 2 16 1 2 16 16 16 16 16 2 16 16 2 1 1 1 1 23 18 
18 18 28 26 26 26 26 26 26 26 29 18 18 18 18 18 18 30 21 21 21 22 1 1 1 1 1 1 1 16 16 16 16 2 2 16 1 1 1 16 16 16 2 1 1 1 1 1 23 18 
18 28 27 2 1 12 13 1 1 1 23 18 18 18 18 18 18 18 18 18 18 30 21 22 1 16 16 1 2 2 2 2 2 2 2 1 1 2 2 2 2 16 16 16 1 1 2 1 23 18 
18 24 12 10 10 11 7 1 20 21 31 18 18 18 18 18 18 18 18 18 18 18 18 24 1 16 1 1 1 2 2 2 2 2 2 16 2 2 2 2 2 2 2 1 2 2 2 2 23 18 
18 24 8 3 35 3 7 2 23 18 18 18 18 18 18 18 18 18 18 18 18 18 18 24 1 1 1 1 1 1 1 1 1 1 16 16 2 16 16 2 1 1 16 16 1 1 1 20 31 18 
18 24 14 5 5 5 15 20 31 18 18 18 18 18 18 18 18 18 18 18 18 18 18 30 21 21 21 21 21 21 21 22 1 1 1 2 2 1 16 2 1 1 1 16 16 1 20 31 18 18 
18 30 21 21 21 21 21 31 18 18 18 18 18 18 18 18 18 18 18 18 18 18 18 18 18 18 18 18 18 18 18 30 21 21 21 21 21 21 21 21 21 22 1 1 1 20 31 19 18 18 
18 18 18 18 18 18 18 18 18 18 18 18 18 18 18 18 18 18 18 18 18 18 18 18 18 18 18 18 18 18 18 18 18 18 18 18 18 18 18 18 18 30 21 21 21 31 19 18 18 18 
18 18 18 18 18 18 18 18 18 18 18 18 18 18 18 18 18 18 18 18 18 18 18 18 18 18 18 18 18 18 18 18 18 18 18 18 18 18 18 18 18 18 18 18 18 18 18 18 18 18 
